NO ./images/N_wide.png
SO ./images/S_wide.png
WE ./images/W_wide.png
EA ./images/E_wide.png

F 100,150,105
C 60,50,110

11111111
10010011
10010001
11000111
110100101
 10110101
 1N110011
 1000001
 1010001
 1000001
 1000001
 1001001
 1111111
