NO ./images/NO.png
SO ./images/SO.png
WE ./images/WE.png
EA ./images/EA.png

F 225,200,0
C 225,30,0

11111111
10010011
10010001
11000111
110100101
 10110101
 1N110011
 1111111