NO /home/42/githubcub3d/images/NO.png
SO /home/42/githubcub3d/images/SO.png
WE /home/42/githubcub3d/images/WE.png
EA /home/42/githubcub3d/images/EA.png

F 225,200,0
C 225,30,0

111111111
1000N11
100010011
1110000E1
10000011
10110101
101 1001
111 1111