NO ./images/N_wide.png
SO ./images/S_wide.png
WE ./images/W_wide.png
EA ./images/E_wide.png

F 100,150,105
C 60,50,110


111111111111111111111111111
100000000011000000000010111
101100000111000W0010000111111
11111001000000000000100000011
	1111111110100001110000001111
	1000000000000000111011111
11110111111101011100000011
11110000000001101110101001
11110100001101110101001111
111100000000011011101010011111
	11110111100001101110101001
	11110111100001101110101001
	11110111100001101110101001
111101111000011011101010011111
11110111100001101110101001
11000001110101011111010011
11111111111111111111111111