NO /home/42/githubcub3d/images/NO.png
SO /home/42/githubcub3d/images/SO.png
WE /home/42/githubcub3d/images/WE.png
EA /home/42/githubcub3d/images/EA.png

F 225,200,0
C 225,30,0

11111111
10001001
10001001
11100001
10E00001
10101001
10101001
11111111