NO ./images/NO.png
SO ./images/SO.png
WE ./images/WE.png
EA ./images/EA.png

F 225,200,0
C 225,30,0

11111111
100001111
10001001
11000E11
100000101
 110110101
 10110011
 1111111