NO ./images/NORTH_100.png
SO ./images/SOUTH_100.png
WE ./images/WEST_100.png
EA ./images/EAST_100.png

C 60,179,110
F 60,179,110


11111111111111111111111111111111111111111111111111111111111111111111111111111111111111111111111111111111
10000000001100000000000011100000000011000S000000001110000000001100000000000011100000000011000S0000000011
101100000111000000000000111011000001110000000000011101100000111000000000000111011000001110000000000011
10010000000000001000000011100100000000000010000000111001000000000000100000001110010000000000001000000011
11111111101100001110000111111111110110000111000011011111111110110000111000011111111111011000011100001101
10000000001100000111011111100000000011000001110111111000000000110000011101111110000000001100000111011111
11110111111101011100000010000000000011010111000000111111111101111111010111000000100000000000110101110011
    1111011110000110110101000000001111000011011101010011111011110000110110101000000001111000011011101011
    11110111100001101 101010000000011110000110111010100111110111100001101 101010000000011110000110111011
    11110111100001101 1101010000000011110000110111010100111110111100001101 11010100000000111100001001001
    11110111100001101 1010100000000111100001101110101001111110111100001101 11010100000000111100001001001
    11110111100001101 1010100000000111100001101110101001111110111100001101 11010100000000111100001001001
    11110111100001101 1010100000000111100001101110101001111110111100001101 11010100000000111100001001001
    1111011110001 10110101001111011110000110111010111001111110111100001101 11010100000000111100001001001
11110111100001101 10101000000001111000011011101010011111111110111100001101 11010100000000111100001001001
11000001 10101011 11010011110000011101010111110100111111101111000011011111 11010100000000111100001001001
11111111 11111111 11111111111111111111111111111111111111111111111111111111111111111111111111111111111111
11111111111111111111111111111111111111111111111111111111111111111111111111111111111111111111111111111111
10000000001100000000000011100000000011000S000000001110000000001100000000000011100000000011000S0000000011
101100000111000000000000111011000001110000000000011101100000111000000000000111011000001110000000000011
10010000000000001000000011100100000000000010000000111001000000000000100000001110010000000000001000000011
11111111101100001110000111111111110110000111000011011111111110110000111000011111111111011000011100001101
10000000001100000111011111100000000011000001110111111000000000110000011101111110000000001100000111011111
11110111111101011100000010000000000011010111000000111111111101111111010111000000100000000000110101110011
    1111011110000110110101000000001111000011011101010011111011110000110110101000000001111000011011101011
    11110111100001101 101010000000011110000110111010100111110111100001101 101010000000011110000110111011
    11110111100001101 1101010000000011110000110111010100111110111100001101 11010100000000111100001001001
    11110111100001101 1010100000000111100001101110101001111110111100001101 11010100000000111100001001001
    11110111100001101 1010100000000111100001101110101001111110111100001101 11010100000000111100001001001
    11110111100001101 1010100000000111100001101110101001111110111100001101 11010100000000111100001001001
    1111011110001 10110101001111011110000110111010111001111110111100001101 11010100000000111100001001001
11110111100001101 10101000000001111000011011101010011111111110111100001101 11010100000000111100001001001
11000001 10101011 11010011110000011101010111110100111111101111000011011111 11010100000000111100001001001
11111111 11111111 11111111111111111111111111111111111111111111111111111111111111111111111111111111111111