NO ./images/N_wide.png
SO ./images/S_wide.png
EA ./images/E_wide.png
WE ./images/W_wide.png

C 0,0,0
F 35,206,235
F 35,206,235


11111111
10010S01
10010001
11000111
11010011
11111111