NO ./images/NORTH_100.png
SO ./images/SOUTH_100.png
WE ./images/WEST_100.png
EA ./images/EAST_100.png

C 60,179,110
F 60,179,110


111111111111111111111111111
100000000011000000000000111
101100000111000W00000000111
100100000000000010000000110
1111111110110000111000011
10000000001100000111011111
11110111111101011100000011
11110111100001101110101001
11110111100001101110101001
11110111100001101110101001
11110111100001101110101001
11110111100001101110101001
11110111100001101110101001
11110111100001101110101001
11110111100001101110101001
11000001110101011111010011
11111111111111111111111111