NO ./images/N_wide.png
SO ./images/S_wide.png
WE ./images/W_wide.png
EA ./images/E_wide.png
EA ./images/E_wide.png


11111111
10010S11
10010001
11000111
11010011
11111111

F 135,206,235
C 135,206,235