F 135,206,235
C 135,206,235
NO ./images/N_wide.png
SO ./images/S_wide.png
WE ./images/W_wide.png
EA ./images/E_wide.png

11111111
1001S011
10010001
11111111
11111111
11000111
11010000
11111111
